
    11111
    1...1
    1b..1    
  111..b11
  1..b.b.1
111.1.11.1   111111
1...1.11.11111..tt1
1.b..b..........tt1
11111.111.1p11..tt1
    1.....111111111
    1111111